8 8
7 0
0 7
#...##..
#.#.#...
#.#...##
#..##..#
#...##..
###.....
#...#...
..###...